+---+---+---+---+---+---+---+---+---+---+---+---+---+---+---+---+
|                       |       |                               |
+   +---+---+---+---+---+   +   +   +---+---+---+---+   +---+   +
|                           |   |                       |   |   |
+   +---+---+---+---+---+---+   +---+---+---+---+---+   +   +   +
|   |                                               |   |   |   |
+   +   +---+---+---+---+---+---+---+---+---+---+   +   +   +   +
|       |                                       |   |   |       |
+---+   +   +---+   +---+---+   +---+---+---+   +   +   +---+   +
|       |                                   |   |   |   |   |   |
+   +   +---+---+   +---+---+---+---+   +   +   +   +   +   +   +
|   |   |       |                       |   |   |       |   |   |
+   +---+---+   +   +---+---+---+   +---+   +   +---+---+   +   +
|               |                   |   |   |   |               |
+   +   +---+   +   +---+---+   +---+   +   +   +   +   +   +   +
|   |       |   |   |       |       |   |   |   |   |   |   |   |
+   +   +   +   +   +   +   +   +   +   +   +   +   +   +   +   +
|   |   |   |   |   |   |   |       |           |   |   |   |   |
+   +   +   +   +   +   +   +---+---+---+   +---+   +   +   +   +
|           |   |   |                               |   |   |   |
+---+---+---+   +---+   +---+---+---+---+---+---+---+   +   +   +
|                   |                                   |   |   |
+   +---+---+---+   +---+---+---+---+---+---+---+---+---+   +   +
|   |           |   |                                           |
+   +   +---+   +   +---+---+   +   +---+---+---+---+---+---+---+
|   |   |       |           |   |       |                       |
+   +   +   +---+   +---+   +   +---+   +---+---+---+   +   +   +
|   |               |   |   |                       |   |   |   |
+   +   +---+---+---+   +---+---+---+---+---+---+   +   +   +   +
|   |                                           |   |   |   |   |
+   +   +---+---+---+   +---+---+---+   +---+---+   +   +   +   +
|   |                               |                           |
+---+---+---+---+---+---+---+---+---+---+---+---+---+---+---+---+