+---+---+---+---+---+---+---+---+---+---+---+---+---+---+---+---+
|   |   |   |                                                   |
+   +   +   +   +---+---+---+---+---+---+---+---+---+---+---+   +
|   |   |       |                                               |
+   +   +   +   +   +---+---+---+---+---+---+---+---+---+---+   +
|           |   |   |               |                       |   |
+---+   +   +   +   +---+---+---+   +   +---+---+---+---+   +   +
|       |   |   |   |                   |                   |   |
+   +---+   +   +   +   +---+---+   +---+   +---+---+---+   +   +
|           |   |   |                   |               |   |   |
+   +---+---+   +   +   +---+   +---+   +---+---+---+   +   +   +
|               |   |   |           |   |               |   |   |
+   +---+---+---+   +   +   +---+---+---+   +---+---+---+   +   +
|   |               |           |       |               |   |   |
+   +   +---+---+---+   +   +---+   +   +---+---+---+   +   +   +
|   |                   |   |       |                   |   |   |
+   +   +---+---+---+---+---+   +   +   +---+---+---+---+---+---+
|   |   |               |   |       |                           |
+   +   +   +---+---+   +   +---+---+   +   +---+   +---+   +   +
|   |               |   |               |                   |   |
+   +---+---+---+   +   +   +---+---+---+---+   +   +---+   +   +
|               |   |   |                       |           |   |
+   +---+---+   +   +   +---+---+---+---+---+---+---+---+   +   +
|           |   |   |   |                                       |
+   +---+   +   +   +   +   +---+---+---+---+---+---+---+---+   +
|       |   |   |   |   |                                   |   |
+---+   +   +   +   +   +---+---+---+---+---+---+---+---+   +   +
|           |   |   |                                       |   |
+   +   +   +   +   +---+---+---+---+---+---+---+---+---+---+---+
|   |   |       |                                               |
+   +   +   +   +---+---+---+---+---+---+---+---+---+---+---+   +
|   |   |   |                                                   |
+---+---+---+---+---+---+---+---+---+---+---+---+---+---+---+---+